R 1200 800
NO ./brick_wall.xpm
SO ./brick_wall.xpm
WE ./brick_wall.xpm
EA ./brick_wall.xpm
S ./red_face.xpm
#F 255,159,0
#C 126,15,0
F funky
C funky
GAME on


1111111111111111111
1000000100010000001
1011010101010101101
1000010001000100001
1011011101011101101
1010000001000000101
1010110111110110101
T00000000000000000T
1011010002000101101
1000010000000100001
1011010000000101101
1001010000000101001
1101010111110101011
T00100000100000100T
101101110N011101101
1000010001000100001
1010110101010110101
1010000100010000101
1011110111110111101
1000000000000000001
1111111111111111111